##############################
#                            #
#                            #
#                            #
#                            #
#                            #
#            #               #
#  8    #    #               #
##############################